makan			melantak	santap     
terbiar		  	ditinggalkan	terabai	
meninggalkan	  	menjauhi 	
mengaibkan         	memalukan 	memburukkan 
memalukan          	mengaibkan	  
pemberhentian		diberhentikan	
tempat(sembelih)	pembantaian	pejagalan
peringkasan		meringkaskan
turun(takhta)		makzul
tindakan(turun takhta)	melepaskan
menyimpang		membelok       	tersasar
bersubahat		berkompromi     bersekongkol
ibrahim			lelaki 		nabi	     	rasul
udara                   angin		hawa
malaikat		makhluk ciptaan Allah drpd Nur cahaya
dikurung		dipenjara
memujuk			merajuk
membencanakan		membinasakan 
bencana			malapetaka		
menghitung		mengira			
kalifah			ketua 
membatalkan		meniadakan 	menggagalkan
kebolehan		keupayaan 	kemahiran
berkebolehan		berkeupayaan 	
menawan			cantik
penyayang		pengasih	pencinta
belaian			usapan		pujukan
syahwat			nafsu
ubi kayu		makanan
terdampar		terbaring
tambak			tebing 		penghalang
berhati-hati		berwaspada
meraikan		menjamu		keramaian	perayaan
pasti			tentu 		mesti		sah
kepastian		ketentuan	kemestian	kesahihan
kristian		aqama
benci			menyampah
kebencian		permusuhan	kemarahan
kepatuhan		ketaatan	kesetiaan
berkekalan		bersahabat	berhubung	bertahuan
kebolehan        	kelayakan	kecekapan
hina			keji		sangat rendah
kehinaan		kehinaan	kekejian
ikrar			janji
pelik			ganjil	
menghapuskan		membinasakan
ibrahim			lelaki		nabi 		rasul
memansuhkan		menghapuskan	membubarkan
pemansuhan		pembsalahgatalan	penghapusan	memansuhkan
menyalahgunakan		disalahgunakan	
terima			ambil		
menyempurnakan		menyiapkan
penyempurnaan		menyelesaikan	melengkapkan	menunaikan
bergantung		mengharap
berkumpul		berhimpun
tepat			betul			
menuduh			menyalahkan	menunjuk	mengatakan	
membiasakan		lazim		teradat		koman		
mancapai		menjengkau	menggapai
masam			asam		masam kucam
kemuncak		tinggi		
memperolehi		memiliki	mendapat
adam			lelaki 		kekasih
mencukupi		memadai		memenuhi		
melekat			berlekat
bersempadan		seberang	bersebelahan
ditangguh		dianjak		
memutuskan		meleraikan 			
dihukum			dipersalah		
merayu			memujuk		meminta	
mentadbir		memerintah
mengagumkan		mempersona
pemuja			peyembah
membenarkan		mengizinkan
menegur			menyapa		mengajak
remaja			dewasa		belia
amalkan			menuntut		
menghiasi		mencantikkan
dewasa			matang		baligh		matang		besar
penzina lelaki		fajir
kelebihan		keistimewaan
musafir			pengembara	petualang	perantau
menasihat		berpesan	berwasiat
menyokong		menyebelahi
kepura-puraan		palsu		
pengasih		penyayang
pergaduhan		perkelahian	pertengkaran	perbantahan	rusuhan
terbakar		tertunu
umur			usia		baya
melekat			berlekat
lincah			cergas		giat		pantas
bersetuju		berbetulan	bertepatan
bantuan			pertolongan	sokongan
uzur			sakit		berpenyakit	gering
udara			hawa		angin
semua			sekalian	seluruh		segala
barisan			deretan		
membenarkan		membetulkan	membolehkan
hampir			dekat		rapat
sedekah			sumbangan	derma		bantuan		dana		pemberian	kebakilan 
sepanjang pantai	kukup		tebing
menyendiri		berseorangan
huruf			lambang		aksara		vokal		konsonan
bersedia		sanggup		rela		sudi		dapat
berubah			pertukaran		
berganti		bertukar	bergilir		
cadangan		pendapat	fikiran
terkumpul		terhimpun
suasana			keadaan		situasi		perihal
meluaskan		melapangkan	melebarkan	membesarkan	
bernyawa		roh		jiwa		hayat		usia
kebimbangan		kerisauan	kerunsingan
bimbang			risau		runsing		khuatir		cuak
melantik		menentukan	menetapkan	mengesahkan
menghargai		menyanjung	menjasai	menjunjung
lulus			lepas 		terus		berjaya
arab			negara		persatuan
orang arab		manusia		orang		insan		makhluk
susun			longgok				
tangkap			cekup
angkuh			sombong
bersekutu		berkawan	bergabung	bersepakat	bersatu
bergaul			bercampur	berkenalan	berkawan
ganjaran		hadiah		balasan
jauh			dura		
menggerunkan		menakutkan	mengerikan	gerun
sekejap			sementara
bayi			anak
mengumpat		mencela		mengejek	memburuk-burukkan	mengutuk
mencemari		mengotori	menodai
minta			mohon
mula			sulung		awal
percaya			yakin		beriktikad	pasti
kewujudan		ada		nyata		benar
punya			ada
belot			khianat		derhaka		tualang
besar			agung		raksasa		gadang
kosong			melompong
menipu			muslihat	helah		dusta
otak			fikiran		akal		benak 		minda
roti			makanan
bernafas		menyedut	bernyawa
perniagaan		firma		
byzantine		empayar
kurung			disimpan	dipenjara
kaherah			tempat	
memujuk			merayu	
mengira			membilang
memanggil		menyebut	meneriak
tenang			aman		damai		tenteram		
mampu			berada		berharta	boleh		sanggup
menawan			cantik		menarik
tanggungjawab		tugasan	
memotong		memenggal	mengerat				
kejadian		peristiwa		
menangkap		memerangkap	mencerap
meraikan		menyambut
pusat			punca		tumpuan		pangkalan	sasaran
istiadat		upacara		majlis rasmi	pengisytiharan		
bayaran			gaji		upah
berbual			bercakap	
menipu			pembohong
penghalang		perintang	penahan		
anak			janin		kandungan  lembaga fetus  bayi
bandar			kota		pekan		kota raya
tutup			sembunyi
pakaian			baju
awan			stratus		motif 		pola
pegang			menggenggam	memaut
kereta kuda		bogi
ayam jantan		mandung		jalak		bacul
memaksa			mendesak
mengumpul		memusatkan
mengumpul		memusatkan
menyusahkan		menyulitkan	menyukarkan
mengikut		mematuhi	ikut telunjuk
membawa diri		berhijrah	mengembara
membentuk		melengkung	melentur
menyembunyikan		menyorok	melindungkan
mengalah		menumpaskan	menewaskan
memikirkan		mengenangkan
menumpukan		memfokuskan	menekankan
perhimpunan		perkumpulan	jamiah
gundik			bini aji	kendak	candik	kendak
nafsu berahi		keinginan	kemahuan	kehendak	dorongan hati
setuju			akur
persetujuan		keakuran	kata bulat	seia sekata
mengutuk		menyumpah	melaknat	mengata
gabungan		ikatan		balutan
pengakuan		penyataan
tempat mengadu		kaunselor
keyakinan		kepercayaan
batas			had		halangan
mengesahkan		membenarkan
penyitaan		penutupan	pengharaman
menggabungkan		penyatuan
pertempuran		peperangan	pergaduhan
bentuk			rupa
mendatangi		menghadiri
mengelirukan		membingunkan
membuktikan		mengesahkan	meyakinkan
kesesakan		kepadatan	kesendatan	kesempitan
berhimpun		berkumpul
bersambung		berhubung
bersubahat		kolaborator
penaklukan		penjajahan
hati nurani		hati bersih	budi pekerti
kesedaran	 	keinsafan
mempertimbangkan 	memikirkan
kumpulan		pasukan		
perlembagaan		perundangan
perundingan		perbincangan
penyempurnaan		melengkapkan
menyentuh		merasa
pencemaran		pengotoran
debat			bahas
menyumbang		memberi
kuasa			daya		kemampuan	keupayaan
bersidang		berbincang
pesalah			penjahat
bersetubuh		berjimak
persetubuhan		penyatuan
kemesraan		keeratan
lembu			binatang
mudah rosak akhlak	terpengaruh
penciptaan alam	 	pemerintah alam	
pencipta		pereka
makhluk			hidupan		ciptaan Allah s.w.t
menangis		merintih
perempuan tua		nenek
tanaman			pendaman	
ramai			penuh	padat	banyak
kejam			zalim
mengusahakan		memajukan
peredaran		putaran
kerosakan		kehancuran
damsyik			tempat
bahaya			berisiko
kegelapan		kelam	kehitaman
anak perempuan	  	remaja	kaum hawa	betina
menantu perempuan	wanita 	kaum hawa	isteri
kemerosotan		kemelesetan	kejatuhan
kematian		kewafatan
menipu			berbohong
menentukan		menetapkan
menurunkan darjat	merendahkan martabat
kemerosotan		kemelesetan
pembelotan		penyelewengan
mempertahankan		memperteguhkan	menyokong
penangguhan		pemindahan
merendahkan		menjatuhkan
memperdaya		menipu		berbohong
desakan			paksaan	
gudang			stor	depot	kepuk
merosakkan akhlak	membinasakan tingkah laku
kehinaan		kutukkan
mengutuk		mengata
menekan			mendail
tergelincir		terjatuh
mewakilkan		mewariskan
terbiar			terabai
mempersendakan		mengejek	ketawakan
berasal			berpunca	permulaan	sumber
keberanian		kekuatan	
keturunan		warisan		zuriat		cucu
menggambarkan		memperlihatkan
rekabentuk		corak		membentuk	mencipta
pembinasaan		kehancuran
kebaikan		perelokkan
pemusnahan		kerosakkan
pengganas		penjahat	pejuang
keji			hina
putus harapan		kecewa
pemerintah kuku 	besi	
kemiskinan		kedaifan	kepayahan
memusnahkan		merosakkan
pembinasaan		kehancuran
meninggalkan		membiarkan
tersangkut		tertandung	kesimpatan
tahanan			dipenjara	
mengesan		mencari
kemerosotan		kejatuhan	kegagalan
penentu			penetap
merosot			atuh		gagal
menentukan		menetapkan
pembantah		pembangkang
berkembang		maju	
nakal			degil
mereka			mencipta
menumpukan		menekankan	memfokuskan
kasih sayang		cinta
berlian			mineral		emas
perbezaan		kelainan
kesukaran		kepayahan
maruah			martabat
bercanggah		terpesong
percanggahan		salah faham		
hilang			lupa
mengecewakan		menghampakan	
tidak berkenan		tidak suka
bencana	malapetaka 	kehancuran	kebinasaan
membubarkan		membatalkan
pengikut		anak buah
menyulitkan		menyusahkan
perbalahan		pergaduhan
syarahan		ucapan
percanggahan		salah faham
penemuan		pencarian
budi bicara		budi perkerti	adab	kelakuan		perangai
membezakan		mentamtizkan
memperhinakan		mengeji
penyakit		masalah
mengecewakan		menghampakan	
penyamaran		penipuan
keaiban			kenistaan	stigma
jijik			hina
keaiban			kenistaan	stigma
penghancuran		pembinasaan
tidak berminat		meyampah
mengecil-ngecilkan	mengerdilkan
penghantaran		pemasaran
penyebaran		diayah		pewahyuan
penyebaran		diaspora
peragaan		pertunjukkan
perampasan		peroncean	penjabalan	pembegalan
membuktikan salah	benar		mensrea		bukti
penyangkalan		penafian	pembantahan	pengingkaran
pertikaian		pergaduhan
pertikaian		pergaduhan
kebimbangan		kerisauan
gangguan		kekacauan
penentangan		pemberontakkan	
tidak puas hati		dendam		iri hati
membedah		membelah
orang kaya yang tidak bermoral	orang mewah yang bongkah
penderitaan		kesakitan	keperitan
pembahagian		pengasingan
kesangsian		keraguan
pelaksana		pengerak
penguasaan		memperketatkan
berani			mampu	kuat
murung			sedih
hantaran kahwin		sesai		belanja hangus
mendadak		cepat
bermimpi		berkhayal
tukang jahit		orang 
minuman			cecair
pemambuk		tukang mabuk
orang suruhan		hamba
keraguan		khilafiah	mencabar	skeptisisme
habuk			celak		serbuk
berminat		kecenderungan
pangkat			darjat
pendapatan		gaji
bumi			planet
kesenangan		keselesaan	
makanan			latifah		latif		kalengan
kegembiraan		keseronokkan
jimat			cermat
kegelisahan		kerisauan
pendidik		pengajar
pendidikan		pelajaran
pemadaman		memadamkan
kesan			hasil		tindak balas
keberkesanan		mujarab
keperempuanan		keayuan
membuih			membusa		mengelembung
usaha			langkah		cara
bersinar-sinar		bercahaya
hala tuju		matlamat
air mani		cecair
pancutan gunung berapi	lava
mengangkat		menaikkan
penaikan		meningkatan
mengugurkan		menjatuhkan
menyingkir		membuangkan
penyingkiran		dibuang
lari bersama kekasih    elope 		elopementn
petah berkata-kata	fasih
menerangkan 		menjelaskan
mengelakkan diri	pengelak	mengumpamakan
sukar ditangkap		susup
mengkuruskan		menkecilkan
kurus kering		keding
bebas			terlepas
benteng			pertahanan
menaiki kapal		belayar		konvoi
memalukan		mengaibkan
sedia untuk bertempur	rela		sanggup
membenamkan		menekankan	memperonyokkan		menikamkan
menghiaskan		mencantikkan
merasa marah		meradang	bengkeng
lambang			logo
terjelma		muncul
memberanikan		menggagahkan	menggeli
kuala			hilir		muara		hilir	bambangan
pemancar		tetuang udara	penyiar
perasaan		soal hati	jiwa
pekerja			kuli
pemilik perniagaan	ketua
kosong			lompong		losong
disihir			dijampi
mempesonakan		menawan
perempuan penggoda	enchantress	femme fatale	wanita	kaum hawa
pertemuan		perjumpaan	
tamat			akhir	penghujung
pengukir		membentuk	mereka
mengasyikkan		mengkhayalkan
menambah		membanyakkan
berseronok		bergembira
permusuhan		perbalahan
terbesar		meluas
cukup			ngam	genap	sampai
mengayakan		membanyakkan
meraikan tetamu		melayan tetamu
menarik			cantik		menawan
irihati			dengki
suasana			keadaan
kesalahan		kesilapan
bersendawa		kuar angin	kenyang
meletup			terpecah
teman			kawan	sahabat
mendirikan		melaksanakan
penubuhan		persatuan
sedap didengar		merdu		temberang
menilai			mengkaji
penilaian		pengujian
hawa			perempuan	angin
rata			datar
siang			pagi
peristiwa		kejadian
pengusiran		menghalau
pengusir		penghalau
bukti			fakta		maklumat
jahat			buruk laku	jelik	nakal	durjana
memperlihatkan		menunjukkan
membangkitan		menaikkan
berkembang		meluas
memadamkan		mematikan
mata			pancaindera	ain
dongeng			tipu	
berseloroh		bergurau senda	cuit	bermain-main
memudahkan		menyenangkan
fakta			bukti
buatan manusia		ciptaan
ikut-ikutan		tiru-tiruan
kegagalan		kejatuhan
rela			sanggup
salah			kurang tepat
keluarga		famili		kelamin		belahan
terkenal		ternama
jauh			dura		besar jaraknya
ladang			kebun 		sawah		bendang
mempesonakan		menawan
puasa			bulan ramadan
kesuburan		kematangan
perayaan		rumah terbuka	dasawarsa
keresahan		kerisauan
syaitan			iblis
api			nyalaan
menunjuk-nunjuk		riak
syurga dunia		kenikmatan	kesenangan	kebahagiaan	
banjir			bah		lembak		
terbang			melayang	mengapung	bergerak di udara
makanan			gizi
kasut			sepatu		selop
dapat diramalkan	diduga
hutan			belukar		rimba		belantara
terlupa			kelupaan	lipur		
memaafkan		mengampunkan
serta merta		mendadak
memelihara anak angkat	pelihara anak orang lain
buah			pencuci mulut	fikiran
penuh			berisi		padat		tepu
asas			utama		penting 	perlu
pengebumian		penguburan
keuntungan		faedah		lebihan		rezeki		habuan
kaki judi		suka berjudi
pergi			menujui		menuju ke	menghala ke
matlamat		objektif	hala tuju
emas			mineral
baik			faedah		elok	bagus	berguna
barangan		barang jualan
tabiat			sifat		kelakuan	perangai
rambut			uban		surai		bulu		
haji			ibadat		
perkampungan desa	luar bandar
tangan			anggota badan	lengan
kepala			jemala	tendas	akal	otak	fikiran	minda
kesihatan		kesegaran	kebaikan
kesihatan		kesegaran	kebaikan
mendengar		memasang telinga
syurga			kenikmatan
neraka			kesengsaraan
sini			di tempat ini
bukit			fakta
tinggi			puncak	panjang		melambung		
harapan			impian
petani			pesawah
persamaan		perserupaan
bodoh			bebal	dungu	benak	bangang
mengabaikan		memalukan
sakit			uzur	gering	lesu	lemah
penganiayaan		penderaan
menggambarkan		melakarkan	melukiskan
merayu			meminta		memujuk
memperbaiki		memulihkan	memperelok	membaharui
memenjarakan		mengurung
memberitahu		melaporkan
pengenalan		mengenalkan	pengetahuan		
penyerangan		melanggar	menyerbu
menterbalikkan		menjungkirkan	menyongsangkan
menyiasat		menyelidiki	memeriksa
mengajak		menjemput	mempelawa
islam			aqama
lelaki			pemuda		dewasa
yakub			rasul		lelaki
penjara			jel		lokap		kurungan
isa			lelaki		nabi		rasul		maryam		injil		israel	
menyertai		mengikuti	mengiringi	mendampingi
yusuf			lelaki		rasul
hutan			belukar		rimba
keadilan		kesaksamaan	sama rata
simpan			memelihara	menyorokkan
kunci			kancing		tutup		selak	katup	ketap	
membunuh		mematikan	menghilangkan nyawa
saudara lelaki		adik		abang
pengetahuan		maklumat	ilmu
buruh			kuli
kekurangan		ketidaksempurnaan	kelemahan
penurut			patuh		taat
lampu			pelita		lampu suluh	lampu picit
pemilik tanah		tuan tanah
besar			luas
baik hati		pengasih	suka menolong	mudah simpati
undang-undang		hukum		peraturan
pemberi pinjaman	along
tanggungjawab		kewajipan
penipu			pengecoh	pembohong
pembebas		mengeluarkan
kehidupan		benda hidup
cahaya			sinar	 	nur	 	pancaran
terbatas		terhad		tersekat
pengecut		penakut
beban			muatan		kandungan	isi	kargo
pinjaman		hutang
mengunci		mengancing	menutup		mengatup
sendirian		seorang diri
panjang			lampai		junjai		tinggi
melihat			menengok	memandang
pemerintah		pentadbiran	cara memerintah
sayang			kasih	cinta	
nasib			takdir
utama			terpenting	mustahak	amat perlu
tiang utama		tonggak		turus	pancang
mengekalkan		memelihara	menjaga
utama			terpenting	mustahak	amat perlu
membuat			melaksanakan	memasak
Tuhan			Maha Esa	Maha Kuasa
mekah			kawasan suci	tempat beribadat	sejenis tumbuhan
niat jahat		kedengkian	kecemburuan
jahat			buruk laku	tidak baik	jelik
mak			ibu		wanita
mengurus		mengatur	menyusun	mengemaskan
manusia			insan		hamba Allah
perkahwinan		pernikahan	ikatan Cinta
tulang sumsum		urat saraf
tuan			pemilik		majikan
kebendaan		barang
keibuan			kewanitaan
baligh			cukup umur	dewasa
sementara		sekejap		seketika	tidak kekal
sukatan			ukuran
perubatan		perihal berubat		kaedah
pesanan			perintah	peringatan
perutus			penghantar		
pemikiran		kaedah		cara berfikir
memperolokkan		mempermainkan	mengejek
ejekan			mempersendakan
musa			Nabi 	rasul	lelaki
muslim			umat islam	muslimin	muslimat	ummah	orang islam
gunung			jabal		cenuram		banjaran	kemuncak
bergerak		bergoyang	beralih tempat	 berpindah
Muhammad		Nabi		lelaki		rasul
emak			ibu	wanita
telanjang		bogel		bolen		bogang
leher			anggota badan 
perlu			mesti	wajib	pasti	tentu
jiran			tetangga
malam			maghrib		senja
rasa takjub		mengagumkan	menghairankan
pemeliharaan		penjagaan
pendayung		pengayuh
patuh			taat		ikut arahan
benda			barang
wajib			mesti		fardu		patut
kewajiban		kemestian	keharusan
pemusnahan		pembinasaan	penghapusan	penghilangan
mematuhi		mentaati
pemerhatian		tinjauan
memerhatikan		memerhatikan	mengamati
menghalang		menahan		menegah
penghuni		penduduk	penunggu
pekerjaan		tugasan		urusan
menghuni		menduduki	mendiami
terjadi			terbentuk	terhasil
laut			samudera	selat		bahar	bahari
pelik			aneh		ganjil		luar biasa	ajaib
kesalahan		kesilapan
sambil lewa		tidak bersungguh-sungguh	
Esa			satu		tunggal
melebihi		melewati	melampaui	mengatasi
mengalahkan		mengatasi	menewaskan
mengalahkan		mengatasi	menewaskan
sakit			uzur		gering		lesu		lemah
ibu bapa		orang tua	
membayar		membeli		
aman			bahagia		damai	tenteram	sentosa
mutiara			mutia
melaksanakan		menjalankan	mengerjakan	menyelesaikan
pelaksana		pengurusan
kekal			baqa	abadi	malar	tekal	tetap
keizinan		kebenaran	keredaan	kerelaan
penyiksaan		penderaan
kebijaksaan		kecerdikan	kepintaran
berpeluh		berkeringat
berkaitan		bersangkutan	berhubung	berkenaan
merebak			menular		memecahkan	meruntuhkan
belas kasihan		mengasihi	menyayangi
tempat			kawasan		wilayah 	daerah		lokasi
helah			sebab		dalih		alasan
berani			gagah		perkasa		bahaduri	kosen
miskin			fakir		papa		daif		melarat
kedudukan		darjat		pangkat
pemilikan		penguasaan
kemiskinan		fakir	papa	daif	susah
kuasa			pengaruh	kemampuan	kekuatan
amalan			perbuatan
berdoa			bermohon	meminta
meramalkan		menjangka
boleh diramal		jangkaan
ramalan			tekaan		telahan
mengandung		hamil
persediaan		persiapan
permulaan		awal		pendahuluan
penyediaan		penyajian	
persediaan		persiapan
bersedia		bersiap		rela	sanggup
wajib			mesti	fardu	patut	hendaklah
tanda			lambang	simbol	cap
penyampaian		pemberian	pemberitahuan
tersebar luas		terkenal
menghalang		mencegah	menegak		menolak
pencegahan		penegahan	penolakan	pengawalan	pengawasan
harga diri		maruah		kehormatan
peribadi		perseorangan	persendirian	kedirian
masalah			kesulitan	kerumitan	kesukaran	kemusykilan
bergerak		bergoyang	berpindah
berarak			berjalan	beriringan
mengisytiharkan		mengumumkan	memaklumkan	memasyhurkan
pengisytiharan		pengumuman	pemakluman
pengeluaran		penghasilan
berpura-pura		berlagak
menghulurkan		melepaskan	memberikan	menganjurkan
keuntungan		kebaikan	manfaat
pergerakan		kebangkitan	perpindahan	perjuangan
melarang		menahan		menegah
larangan		tegahan
utama			penting 	mustahak
janji			waad	waadat	iltizam		ikrar	sumpah
harta			kekayaan	pusaka		kemewahan		kebendaan
nabi			utusan Allah	pesuruh Allah		rasul		lelaki		penyampai	penyebar	pendakwah
muhammad		lelaki		rasul
meminang		melamar
pengharaman		pelarangan	penegahan
melindungi		membela		menjaga		memayungi
dilindungi		dijagai
perlindungan		penjagaan	
pembantah		melawan
bantahan		sanggahan	sangkalan
pencari nafkah		mendapatkan rezeki	bapa
sementara		seketika	sekejap		tidak kekal
haluan			arah		hala	tuju	hadap
masuk campur		ikut serta	campur tangan
berpura-pura		berlakon
rakyat			warganegara	penduduk	bumiputera
tarikan			ajakan
menghukum		mengazab	mengkritik	menganiaya
boleh dihukum		dikenakan tindakan
penghukuman		keputusan
pembelian		berlanggan		
pembeli			pelanggan
purdah			tirai		kain
tulen			asli	jati	murni
memburu			menggesakan	
membekalkan		menyediakan
pembekal		penjual		penyedia
tolakan			dorongan	sorongan
meletakkan		menempatkan	memasukkan	melepaskan	memberi
membusuk		mereput		merosak
gempa bumi		tanah goyang	
kelayakan		kebolehan	kecekapan	kesanggupan
lulus			berhasil	
soalan			kuiz		
boleh disoal		ditanya
penyoal			penaya
barisan			deretan		garisan
rungutan		alasan		
cepat			lekas		segera		pantas		deras
pertanyaan		soal selidik
mematahkan		menggagalkan
memadamkan		menghilangkan		
mencari			meneroka
cepat			lekas 		segera
senyap			diam
berhenti		berehat
pembelot		pengkhianat
mudah putus asa		mengalah
getaran			gegaran		pegerakan		
kaum			etnik
menyeksakan		menyakitkan
penderaan		penyeksaan
hujan lebat		tengkujuh			
hujan ribut		taufan
Ramadan			bulan puasa
peladang ternak		penternak
kerakusan		kemusnahan
cepat			lekas		pantas
perogol			perkosa
kebinasaan		kemusnahan
mempesonakan		menawan
mentah			belum masak	belum diproses		
sinar mentari		cahaya
mencampai		mendapat
pembacaan		menelaah		
pembaca			penelaah
kenyataan		kepastian
memungut hasil tanaman	mengambil upah
pemikiran pertimbangan	berserah
pengenalan		pendahuluan
mengingat kembali	kenal semula		
daya ingatan tajam	keupayaan mengingat yang kuat
mencadangkan		mengusulkan	menyarankan	menganjurkan
berdamai		berbaik semula			
membetulkan		memperbaiki
pulih 			sihat
dayus			takut
pembetulan		pembaikian		
pemulihan		pembaikan
berulang		sekali lagi	melakukan kembali		
berulang-ulang		bertubi-tubi	berkala
ingkar			menafikan	menyangkal		
menebus			mengadai	menukar
penyelamat		pemupus		
penebusan		pengantian	penukaran
terhuyung-hayang	seroyongan	sempoyongan
menyelidik		mengkaji
membentuk semula	memulihkan kembali
menyegarkan		menyamankan
menyejukkan		mengompres	mengipasi	menjaram	mengadem
perlindungan		langkah keselamatan	
pelarian		pengungsi		
bayaran balik		memulangkan semula	
membersihkan		menceriakan
penolakkan		pembuangan			
penyangkalan		penafian	pembantahan	pengingkaran
menyangkal		menidakkan
sedar semula		insaf
menjamu selera		makan
mengambil berat		ambil tahu
tumbuh semula		hidup
kebangkitan semula	kehidupan kembali
rosot kembali		menurun semula
rasa sesal		menyesal
berkumpul semula	berjumpa kembali	bersua	
biasa			lazim		
ketetapan		ketentuan
melazimkan		membiasakan
mengawal		menjaga
pengawalan		penjagaan
pengatur		penyusun
pemulihan		pembaikan
membicarakan		mengatakan
pemerintahan		pentadbiran
memperkukuh		memperkasa
menjelma rosak		memberi kemusnahan		
penjelmaan semula	kemunculan
memperteguh		memperkuatkan
mengembalikan jawatan	menjawat semula
pengulangan		mengulangi	
mengulang		mengkaji semula
penolakan		penangkisan	penentangan	pencegahan	penafian			
melengkapi semula	mencukupi kembali
berasa girang		gembira
menyertai semula	mengikuti kembali
jawapan			objektif	jawaban
bernyala semula		bersinar kembali
berkaitan		bersangkutan	berhubungan	berkenaan	
bertenang		bersabar		
pembebasan		pengampunan	demiliterisasi
berlembut		berhalus
tidak henti-henti	berkobar-kobar	becok	rengek
berkaitan		berkenaan
kelegaan		kesegaran
lega			segar
agama			ajaran
meninggalkan		pergi
nikmat			enak		anugerah Allah	
mrngenang		mengingati
menempatkan semula	menduduk kembali
penempatan semula	menempatkan kembali
keengganan		kedegilan
berharap		keinginan
tinggal			duduk
sisa-sisa		tidak guna	tidak bermanfaat
tahanan			halangan	rintangan		
kata-kata teguran	nasihat		peringatan
luar biasa		ajaib		abnormal
perkahwinan semula	pernikahan sekali lagi
berkahwin semula	berkahwin sekali lagi
boleh dipulihkan	dapat diubati
ubat			supositori	kumur
ingat			sedar		hajat		
peringatan		nasihat		teguran
mengingatkan		pengingatan	menegurkan	peringatan
peringatan		nasihat		teguran
teringat		terkenangkan	teringatkan	terfikir
pengampunan		pembebasan
membentuk semula	bangkit sekali lagi
pembantahan		penyangkalan
pembantah		pelawan
membantah		menentang	melawan
sesal			kesal		keinsafan
penuh sesal		cukup kesal	
tanpa belas kasihan	tiada timbang rasa
terpencil		terasing	kesendirian
boleh ditanggalkan	dapat dihilangkan
pemindahan		penghijrahan
ganjaran		bonus 		gaji	pahala
mengganti		menukar		
melepaskan		membebaskan
terkenal		diketahui ramai
membuka semula	 	memdedahkan	melepaskan
menduduki semula 	menyertai 	memasuki	 mengambil bahagian
membaiki	 	membetulkan
pengulangan	 	mengulangi
mengubah 	 	menukar kepada yang lain	 membaiki
pengubahsuaian 	 	modifikasi
pengubah 	 	pengalih
kegemilangan 	 	kejayaan
sewa 		 	wang yang dibayar untuk menggunakan sesuatu,tambang
pelepasan	  	dikecualikan	melepaskan sesuatu
pendudukan semula  	menduduki semula
menduduki semula 	mendiami semula
penyusunan semula 	menyusun 
menggantikan 	 	memberhentikan
mengeluh 	 	merintih
boleh diganti	 	boleh ditukar
akibat		 	hasil		kesudahan
menambahkan		memberi tambah
jawapan          	balasan
laporan	         	pemberitahuan
membuka semula		mendedah sekali lagi
menduduki semula	mendiami sekali lagi
membaiki		membetulkan
pengulangan		mengulangi
mengubah		menukar		memperbaiki	menyusun semula		
pengubahsuaian		mengubahsuai	modifikasi
pengubah		pengalih
kegemilangan		kejayaan
sewa			biaya
pelepasan		pembuangan	pemecatan
pendudukan semula	menduduki kembali
menduduki semula	mendiami kembali
penyusunan semula	menyusun kembali
menggantikan		menukarkan	mengubahkan
mengeluh		merintih
boleh diganti		dapat ditukar
akibat			hasil		kesudahan	padahan
menambahkan		meningkatkan
jawapan			balasan
laporan			pemberitahuan
rehat			mengaso	
damai			aman		rukun		harmoni
merupakan		membentuk	membuat		menjadikan
menahan			menghentikan	menyekat	
menahan nafsu		menyekat kehendak 
penangguhan hukuman	penundaan balasan
teguran			kritikan	cerca
menegur			mencela		mengkritik
teguran			celaan		ajaran		cerca		kritikan
terkutuk		terlaknat
kutukan			sumpahan	makian		cerca		nista
membiak			bertambah-tambah	menular
pembiakan		aseksual	klon	pisikultur		isogami
pembiakan		aseksual	klon	pisikultur		isogami
penolakan		penampikan	penangkalan	penangkisan	pencegahan	pengurangan
menangkis		menepiskan	mengelakkan
menjijikkan		menggelikan	meluatkan
permintaan		permohonan
memerlukan		memustahakkan	memestikan	mewajibkan
keperluan		keharusan	kemestian
balasan			jawaban		ganjaran	hukuman
penyelamat		pemupus		almukhalis
menyelidik		mengkaji	memeriksa	menyiasat
keserupaan		kesamaan rupa	
serupa			sejenis		semacam
rasa geram		gerigit
geram			marah		panas hati	sakit hati
simpanan		tabungan			
askar simpanan		tentera sokongan
membetulkan semula	memperbaiki kembali
menetap			bermastautin	bermukim
membentuk semula	menyusun kembali
tinggal			bermukim	menetap
menentang		melawan
tentangan		perlawanan	
ketegasan		kepastian	
azam			matlamat
gema			gaung kumandang			
bergema			bergaung	berkumandang	bertalun-talun
sumber			asal		mula		punca
bijak			bijak		pintar
hormat			khidmat		takzim
dihormati		disanjungi
penuh hormat		beradab
pernafasan		perbuatan bernafas
bernafas		bernyawa	hidup
menjawab		membalas	menyahut
jawapan			balasan		penyelesaian
bertanggungjawab	amanah	
rehat			istirahat
mengembalikan		memulangkan
sekatan			halangan	rintangan
mengehadkan		membataskan
terhad			terbatas	khusus
sekatan			halangan	rintangan
hasil			keuntungan	pendapatan
timbul sebagai akibat	kesan
menyambung		memanjangkan	meneruskan	menghubungkan
kebangkitan		kebangunan	kesedaran	pemberontakan
membangkitkan		membangunkan	menaikkan	mengangkat ke atas
menghidupkan semula	menggerakkan kembali
mengekalkan		mengabadikan	
orang gaji		bibik
membalas		membayar
tindakan balas		kesan
melambatkan		melengahkan
ingatan kuat		fikiran cerdas 
berfikir semula		bermenung kembali
berat mulut		pendiam
segan			malu
rombongan		kumpulan
berhemat		berjimat	berhati-hati
perbicaraan semula	pengadilan kembali	
mendapatkan semula	memperoleh kembali
hasil buruan		dapatan dari buru
mengembalikan		memulangkan
menampakkan		menunjukkan	memperlihatkan
membalas dendam		bertindak diluar jangkaan
bertentangan		berlawanan	bermusuhan
pulih			baik
beredar			pulang
kaya			berharta	berada		berkuasa
menunggang kuda		menaiki	kuda
hak			kuasa		milik		kepunyaan	
koyak			rombeng		sobek			
masak			ranum		empuk		matang		mahir
sungai			air
jalan			haluan
batu			kerikil	
akar			umbi
kasar			kesat		angkara		berat		
baris			deret		jajar		lajur		leret
menggosok		membersih	mengilap	menyeterika
biadap			tidak tahu adat
peraturan		dasar		tapak
lari			berkejar
tergesa-gesa		gopoh-gopoh
kesucian		kemurnian
berkorban		memberi sesuatu sbg korban
sedih			susah hati	sedu
selamat			aman		sentosa
upah			ganjaran
assalamualaikum		damai padamu
penjualan		menjual
sama			serupa		mirip
suci			bersih		soleh		murni
pasir			kersik halus
iblis			iblis		
sarung pedang		selongsong pedang
menakutkan		menggerunkan
bau wangi		harum
cemuhan			celaan		 ejekan
jeritan			pekikan		 teriakan
kitab			buku suci
rasa bersalah		rasa silap
laut			segara
mencari			berusaha menjumpai sesuatu
berahsia		menyembunyikan
duniawi			keduniaan
tenang			aman
penggoda		pengacau
tekun			bersungguh-sungguh
terpilih		dapat dipilih			
mementingkan diri	mengambil berat
jual			menjual		 berjual
deria			alat perasa
peka			cermat		 hati-hati
syahwat			keinginan kuat hawa nafsu
palsu			tiruan
celaka			sial		 malang
contoh			sampel, model
ditutup			tidak terbuka
malu			segan
sakit			menderita	 kesusahan
penglihatan		kebolehan melihat
tanda			lambang		 isyarat	alamat
perak			logam putih
perumpaan		bidalan		 ibarat
memudahkan		menggampangkan
dosa			mungkar		  kejahatan
jujur			ikhlas		  lurus hati
bernyanyi		berlagu
duduk			tempatnya	  tinggal
kulit			tisu nipis membaluti tubuh 
langit			angkasa
selekeh			kotoran, noda		
hamba			khadam		kuli
tidur			lelap
hiris			kerat		penggal
terbelah		berpecah
kecil			tidak besar	muda		halus		sedikit
berkecai		berpecah
pelanggaran		penyerangan	penyerbuan
hidu			mencium		membaui		mengetahui	mengesan
asap			gas
ular			binatang 	akar			
kilat			cahaya
selesa			lega		luas	
esakan			sedu-sedan
lembut			lemah		lemas		lembik		lunak
penyelesaian		membereskan
sulaiman		lelaki		nabi		rasul
anak lelaki		orang
roh			jiwa		semangat
bunyi			suara
punca			permulaan	pendahuluan	hujung
tempat			bekas		wadah		ruang
bercakap		bertutur	berkata		berbahasa
pertuturan		sebutan		ucapan
mengejai		merentangkan	meregangkan
berbelanja		membeli-belah
pusingan		edaran		kisaran		kitaran
pergaduhan		perkelahian	persengketaan	pertelingkahan
kebuluran		kelaparan
negara			negeri
menghentikan		memberhentikan
mencuri			mengambil secara paksa
kedekut			bakhil		lokek		kikir		pelit
batu			mineral			
penyimpanan		perihal menyimpan
simpanan		sesuatu yang disimpan
berhenti		berehat
ribut			angin kencang	badai		
cerita			kisah		riwayat
pantai			pesisir		tebing laut	tepi laut
orang yang dikenali	artis
tenaga			daya		kekuatan	kebolehan
tekanan			desakan		paksaan
persengketaan		perbantahan	pertengkaran
taklukan		jajahan
berjaya			berhasil	menang		mencapai kemajuan
pengganti		menggantikan	
tunduk			merendah	mengaku kalah
menghisap		menyedut
menetek			menyusu
menderita		kesakitan	keseksaan
waktu panas		tengah hari
arahan			perintah	petunjuk	pimpinan	pengawalan
matahari		matari		mentari		suria
bekalan			persediaan
alam 			buana		bumi		dunia		jagat
meninjau		memerhatikan
dicurigai		disyaki
menyumpah		mengutuki	menyeranah	menyerapah	bersumpah
kelengkapan		alat perkakas
kebijaksanaan		kepandaian
mengambil		membawa		memungut	menerima	mengurang
berkata-kata		bercakap
tinggi			panjang		jauh
jinak			ramah		tidak liar
menyeleweng		menyimpang
ketara			nyata		terang
ketukan			pukulan
lambat			perlahan	lewat	
sasaran			target		tujuan
tugas			arahan		perintah
rasa			pendapat	fikiran
koyak rabak		cabik-cabik
perbualan kosong	mengumpat
kaki mengumpat		suka mengata
lusuh			luntur		kumal		renyuk
cemuhan			celaan		ejekan
menegang		merentang	menjadi tegang
mengajar		latih		
kumpulan		pasukan
koyak			terbuka
tidak boleh diharap	tidak dapat tolong
mengusik		mengacau	menyakat
penuh sesak		cukup sibuk
remaja			muda
memberitahukan		memberitakan	melaporkan
ribut kencang		badai
penggoda		pengacau	pengusik
dapat dipertahankan	boleh dijaga	
ketabahan		keberanian	kecekalan hati		keteguhan hati
mudah menjaga		senang dibela
cemas			takut
kemah			khemah	
syarat-syarat		undang-undang		
menggerunkan		menakutkan
ujian			peperiksaan
bukti			fakta
meninggalkan wasiat	pewasiat
terima kasih		syukur		mensyukuri
bersyukur		keredhaan
mencuri			merampas
benda			barang	
berfikir		berakal		beringat
berduri			beranjau
hamba			kuli		khadam		pacal		patik
mengancam		membahayakan	
balingan		lontaran	lemparan
singgahsana		istana
ketat			sendat	 tegas	teliti	
bercucuk tanam		menanam
masa			waktu		
penat			letih
bersama-sama		bersatu
nada suara		bunyi suara
lidah			perasa
alat			benda
tumbang rebah		jatuh
seksaan			azab		derita
goyah			goyang
sentuhan		cuitan		rabaan
kuat			perkasa		gagah
mengembara		menjelajah
bandar			ibu kota
tanda			lambang 	logo
berdagang		berniaga
memfitnah		mengumpat
mengubah		mengalih	
pengangkutan		transpor	pembawaan
diterjemahkan		versi		bahasa sumber
perangkap		jerat		jebat		simbat
perjalanan		pengaliran	berkonvoi	menggembara
khianat			derhaka		curang		tipudaya
khianat			derhaka		curang		tipu daya
harta tersorok		harta karun
melayan			mempedulikan	mengendahkan	
muslihat		tipu		jerat
perjalanan		pengaliran	berkonvoi	menggembara
benar			betul
kepercayaan		keyakinan	kepastian
mencuba			memeriksa	menjajal
pusingan		putaran
jenis			golongan
hodoh			buruk
bersatu			berpadu
biasa			lazim		pernah
kosong			lompong
samar-samar		kabur
berani			gagah		perkasa		bahaduri	
mengesahkan		mengisbatkan	memperakui	mengabsahkan	mentashihkan
bertentangan		bercanggahan
kelainan		perbezaan
pelbagai		bermacam
luas terbentang		panorama
sayuran			jenis-jenis sayur
menjual			berniaga
bisa			racun
kata-kata		ucapan
mangsa			penderita	pesakit	
kemenangan		kejayaan
pandangan		pendapat
mencerca		menghina
boleh dilihat		dapat nampak
ternyata		terbukti	ketara		ketahuan
matlamat		objektif	wawasan	
melawat			menziarahi
suara			nada
raungan			jeritan dalam tangisan
tunggu			menanti
terjaga			terbangun	tersedar
berjalan		bergerak
dinding			tembok		kubu		pagar
tongkat sakti		kayu ajaib
perang			permusuhan	asabat
panas			hangat
waspada			waskita		bersiap-siap	berjaga-jaga
membasuh		membilas	mencebok
memperhatikan		meninjau	membelek	menilik		menatap
air			minuman		air sungai
lilin			bahan api
gelombang		ombak		getaran		gerakan
jalan			landasan	denai		usaha
kelana			pengembara
lemah			lesu		lembam
kaya			berharta	kaya dengan
cuaca			hawa		iklim		keadaan udara
pelik			aneh		ganjil		ajaib
sihat			afiat		pulih		
sesiapa			siapa-siapa			
lebar			besar
liar			ganas		buas
angin			hawa		udara
tingkap			jendela
sayap			kepak
hajat			permintaan
perempuan		kaum hawa
ajaib			hairan		takhub		pelik	aneh		
rahim			rahmat
kayu			kayan		perun
kerja			khidmat		karya
dunia			alam		bidang
bimbang			risau
menyembah		menundukkan
murka			marah		meradang
dajal			buruk		jahat
tulis			menulis
salah			tidak betul
bersungut		mengomel	menggerutu	merungut
tahun			masa		waktu
jeritan			teriakan
kuning			warna
semalam			kelmarin
hasil			kesan
berzaman		jangka masa yang lama
kamu			engkau		awak		
lolongan		jerit		raung
semangat		roh		kemahuan		
fanatik			taasub
tunjuk			memperlihatkan
kelahiran		terhasil	kejadian	kewujudan	kehidupan	persenyawaan
raja			sultan
beriman			Mukmin
mata			pancaindera	bilah 	markah
tanda			lambang
hari			isnin	selasa rabu khamis jumaat sabtu ahad		
kiamat			akhirat
membuktikan		mengesahkan
kewujudan alam		tecipta buana
tanda-tanda		gejala		alamat
raja-raja		sultan-sultan
wajibnya		tanggungjawabnya
wanita			perempuan	wadun	kaum hawa	kaum ibu
menutup			mengatupkan
aurat			kemaluan	alat kelamin	rambut
kepentingan 		keutamaan
ilmu			pengetahuan
tanggungjawab		kewajipan
tanggung		menyara
jawab			memberi jawapan	
anak			janin		zuriat	
ibu			bonda
bapa			ayahanda
abang			kekanda		kanda		
adik-beradik		sekedim
kakak			kakanda
adik-adiknya		adindanya	saudaranya
adik			adinda	saudara	ading	yayi	ari
ciri-ciri		sifat-sifat
ciri			sifat	tabii
berpakaian		berbusana		
islam			aqama
kelebihan		keistimewaan
berpuasa		menahan diri		
sembahyang		solat
kesihatan		afiat		
kewajipan		tanggungjawab
cerita			kisah
hudud			peraturan yang ditetapkan oleh Allah s.w.t batasan
mewajibkan		kemestian	memestikan	mengharuskan
jumaat			hari	
hukum			ketetapan
mencuri			mengambil
perempuan-perempuan	kaum wanita
perempuan		wanita
haram			hukum		tegahan		ditegah
dikahwini		dinikahi
kebesaran		kemuliaan	kehormatan
allahelat 		Tuhan		Yg Esa
kejadian		peristiwa
gunung-ganang		bukit-bukau	
laut			kulzum		selat	bahar	samudera			
quran			kitab
mukjizat		kelebihan
kalimah			lafaz	
syahadah		tasyahud	pengucapan	alamin		syahadat
sembahyang		solat
puasa			perbuatan menahan diri	ibadat
zakat			bayaran
haji			qiran	ibadat
solat			sembahyang
sunat			tak diwajibkan
perbezaan		ketaksamaan	kelainan
islam			aqama		
kristian		nasrani		Masihi	
yahudi			ibrani		farisi
perkaitan		asosiasi	hubung kait	simbiosis
persamaan		pertepatan	perserupaan
keturunan		zuriat	darah	piut	cucu
rasul			lelaki	utusan Allah
sejarah			sastera lama		
peperangan		pertempuran	perjuangan
perkahwinan		pernikahan			
kisah			cerita
lelaki			manusia
tertidur		terlelap
gua			batu		
beratus-ratus		gulai
ratus			mengoceh			
tahun			masa								
keadaan			suasana
jannah			surga
neraka			hawiah		
menyucikan		membersihkan
diri			tubuh badan	batang tubuh	orang seorang	empunya badan
tuntutan		tanggungjawab
berperang		bermusuh	konflik
jalan 			haluan
allah			Tuhan		Yg Esa
berdakwah		menyampaikan
kewajipan		tanggungjawab
malapetaka		bencana
bumi			planet 
petunjuk		panduan		bimbingan	
kandungan		janin		anak
jumaat			hari
